#############################
#                           #
#                           #
#                           #
#                           #
#                           #
#                           #
#                           #                             
#                           #
#                           #
############# ###############