                             
 ########################### 
 #                         # 
 #   #                     # 
 #   ##                    # 
 #                         # 
 #                         # 
 #                         # 
 #                         #                             
 #                         # 
 ########### ############### 
                             